13;13;tiles01.png;pop.mid;DM;Miki;Popcorn theme map
77;77;0;51;51;0;179;179;0;29;29;0
0000000000000
0110011001100
0110011001100
0000000000000
0001100011000
0010010100100
1101100011011
0100010100010
0100111100010
1101100110011
0010000001000
0001100110000
0000111100000
