18;14;tiles01.png;doom1.mid;DM;Miki;Test map for the Coon Runner Pygame
18;18;59;36;36;117;99;99;207;6;6;20
111000011111111111
100000000010000001
100000100010000001
100100001000111001
100111111100010001
100100011011110001
100100010000010001
100100001110110001
100100000000010001
100000001000010001
100111111111100001
100001000000000001
100001000000000001
111111111111111111