18;14;tiles01.png;doom1.mid;DM;Miki;Test map for the Coon Runner Pygame
18;18;59;36;36;117;99;99;207;6;6;20
111111111111111111
000000000010000001
000000000010000001
000000000000111001
000110000100010001
000100011011110001
000000010000010001
000100001110110000
000100001000010000
000100001000010000
000111111111110001
100000000000000001
100000000000000001
111001111111111111